# **************************************************************************** #
#                                                                              #
#                                                         :::      ::::::::    #
#    map.ber                                            :+:      :+:    :+:    #
#                                                     +:+ +:+         +:+      #
#    By: jhermon- <marvin@42lausanne.ch>            +#+  +:+       +#+         #
#                                                 +#+#+#+#+#+   +#+            #
#    Created: 2021/12/22 14:36:49 by jhermon-          #+#    #+#              #
#    Updated: 2021/12/22 14:41:27 by jhermon-         ###   ########.fr        #
#                                                                              #
# **************************************************************************** #

111111111111111111111111111111111111
100000000000000000000000000000000001
10000P000000000000000000000000000001
100000000000000000000000000000000001
100000000000001011000000000000000001
100000000000001000000000000000000001
100000000000001000000000000000000001
100000000000001111111100000000000001
100000000000000000000000000000000001
100000000000000000000000000000000001
111111111111111111111111111111E11111
